aa....*.
a.......
........
*......*
..4..*.*
.*......
....*.*.
*......*
