aa......
a...*..4
....*...
...*..**
.......*
...*....
.*......
...*.*..
