.........
.A..*..4.
....*....
...*..***
.......**
...*.....
a*.......
aa*.*....
