......aa
....*..a
.*..*...
**4.....
.**....
.*..***.
.......*
...A....
