aa..*.*...
a...*.....
...*......
...*......
.3........
.*...**...
..........
......**..
..........
.........A
